_________________
_______ggg_______
_______g_g_______
_ss___g___g___ss_
23s__gg___gg__s32
sss_ggg___ggg_sss
____ggg___ggg____
___ggg__r__ggg___
___ggg_rrr_ggg___
__ggg__brb__ggg__
__ggg___b___ggg__
_ggg_________ggg_
ggg___________ggg
gg_____________gg
g_______________g
____r_ttttt_r____
___rr_e___d_rr___
___bb_e___d_bb___
ss____d___e____ss
______e___d______
sssssss___sssssss
