bwt________yyyyyy
_bwt_______yyyyyy
__bwt____________
___bwt___________
____bwt__________
_____bwt_________
ggggggbwtgggggggg
_______bwt_______
________bwt______
__rr_____bwt_____
_rrrr_____bwt____
grrrrggggggbwtggg
_rrrr_______bwt__
_rrrr___cc___bwt_
__rr____cc____bwt
_______________bw
__________ccc___b
______ccc_ccc____
______ccc________
_________________
