_________________
_________________
_y____y_y___y_y_y
___b_b__wy__yy_yy
b_b_ww_www_b_byby
___wy_b__y___bryr
bb__y____w_y_br_y
__wyyb__ww_bbryy_
wyw____bbbb_rry_y
yyy_y_yyyy_yryyyy
y_wy_yw____ry_yyy
__w_______rry__yy
___wwb_y__ry_b_y_
___y____rr_______
s_s_s_s_s_s_s_s_s
_________________
_________________
_________________
_________________
_________________
_________________
_________________
