_________________
_________________
_________________
_________________
rrr_______ttt____
rwr__yyy__twt____
rwr__ywy__twt____
rrr__ywy__ttt____
rrr__yyy__ttt____
_g___yyy___g__ccc
_g____g____g__cwc
gg___gg____gg_cwc
gg___ggg___gg_ccc
_g____gg___gg_ccc
_gg___g____g___g_
_gg___g____g___g_
_g____g____g__gg_
_g____g____g__ggg
_g____g____g___gg
_g_____________g_
_g_____________g_
_g_______________
