_________________
_________________
_________________
sssssssssssssssss
s______y3y______s
sgggggggggggggggs
sggsssssssssssggs
________w________
____sssssssss____
________g________
_____sssssss_____
________w________
______sssss______
________g________
_______sss_______
________w________
________s________
_________________
_________________
_________________
_________________
