_________________
_________________
_______www_______
________w________
_______www_______
________w________
________w________
________w________
________w________
________w________
________w________
________w________
________w________
wwwwwwwwwwwwwwwww
_w_____________w_
__wbbbbbbbbbbbw__
___w_________w___
____wbbbbbbbw____
_____w_____w_____
______wbbbw______
_______w_w_______
________w________


