_________________
_________________
_sss_________sss_
__1s_________s1__
_23s_________s23_
___s_________s___
___s_________s___
ssss_________ssss
_________________
_________________
_________________
_________________
_________________
_________________
________d________
_______sss_______
_______sss_______
_______sss_______
_______sss_______
_________________
_________________
_________________
_________________
_________________
