_________________
_________________
_____ywwwy_______
______www________
______twt________
______www________
______wcw________
_______w_________
_______w_________
__w____w____w____
__cwwwwwwwwwc____
_______w_________
_______w_________
_______w_________
_______w_________
______www________
_____ww_ww_______
_____w___w_______
_____w___w_______
_____w___w_______
_____w___w_______
_________________
