_________________
_________________
_________________
_________________
____r_______b____
ccccrsssssssbcccc
___rrs_____sbb___
_____s_www_s_____
_____s_www_s_____
_________________
_________________
_____ccccccc_____
_r_s_c_____c_s_b_
_r_s_c_ggg_c_s_b_
___s_c_ggg_c_s___
ssss_c_____c_ssss
_________________
wwwgggwwwwwgggwww
_________________
_________________
_________________
_________________
