_________________
_________________
__bb__23232__rr__
__bb__32323__rr__
_________________
__wwwwwwwwwwwww__
____yyyyyyyyy____
__wwwwwwwwwwwww__
_________________
_________________
___111_____111___
___111_____111___
___111_____111___
_________________
_________________
_________________
_________________
_________________
ccccccccccccccccc
ggggggggggggggggg
ccccccccccccccccc
_________________
_________________
_________________
