______ggggg______
_____gg___gg_____
____gg_r_r_gg____
____gg_____gg____
_____gg___gg_____
__g___ggggg___g__
___gg___g___gg___
_____ggggggg_____
________g________
________g________
________g________
_______gsg_______
______gg_gg______
______g___g______
_____g_____g_____
____gg_____gg____
_________________
_________________
_________________
_________________
