_________________
_________________
_________________
_____rr___rr_____
____rrrr_rrrr____
____rrrrrrrrr____
____rrrr2rrrr____
____rrr222rrr____
_____rrr2rrr_____
_____rrrrrrr_____
_____rrrrrrr_____
______rrrrr______
______rrrrr______
_______rrr_______
_______rrr_______
________r________
_________________
_________________
_________________
_________________
_________________
_________________
