_________________
_________________
_________________
_________________
_s_y_________y_s_
_s_____www_____s_
_s_____www_____s_
_s__b_______b__s_
_s_____________s_
_s____ddddd____s_
_s____ds3sd____s_
_s____ddddd____s_
_s__b_______b__s_
_s_____________s_
_s__ggg___bbb__s_
_s__ggg___bbb__s_
_s__ggg___bbb__s_
_s_____________s_
_______ddd_______
_sssssseeessssss_
_______ddd_______
_________________
_________________
_________________
